11111111111111113333
10000000000000013333
10000000000000013333
10000000000000013333
10000000000000013333
10000000000000013333
10000000000000013333
10000000000000013333
10000000000000013333
10000000000000013333
11111111111111113333
33333333333333333333
33333333333333333333
33333333333333333333
33333333333333333333