333333333333333333333333
333333333333333333333333
333333333333333333333333
333333333333333333333333
333311111111111111113333
333310022044400005513333
333310000000000002213333
333314400000022000013333
333310002000000000013333
333310000000444440013333
333312200000000000013333
333312000000200044413333
333310044440000000013333
333310000000000440013333
333311111111111111113333
333333333333333333333333
333333333333333333333333
333333333333333333333333
333333333333333333333333